A A A A A A A A A A A A A A A A A A A A A A A A A A A A A A A A
A X X X X X X A X X X X X X X A A X X X X X X X X X X X X X A A
A X X X X B X X X X X X X X X A A X X X X B X X X X X X X X A A
A X X X X X X A A A A A X X X A A X X X X X X X X X A A A A A A
A A A A A A A A X X X A X X X X X X X X X X X X X X A A A A A A
A X X X X X X X X X X A X X X A A X X X X X X B X X X X X X A A
A X X X X X X X X X X A X X X A A X X X X X X X X X X X X X A A
A X X X X B X X X X X A X X X A A X X X X X X B X X X C X X A A
A X X X X X X X X X X A X X X A A X X X X X X X X X X X X X A A
A X X X X X X X X X X X X X X X X X X X X X X B X X A A A A A A
A X X X X X X X X X X X X X X X X X X X X X X X X X A A A A A A
A X X X B X X X X X X A X X X A A X X X X X X X X X X X X X A A
A X X X X X X X X X X A X X X A A X X X X X X X X X X X X X A A
A X X X X X X X X X X A X X X A A X X X X X X X X X X X X X A A
A X X X X X X X X X X A X X X X A X X X X X X X X X X X X X A A
A X X X X X X X X X X A X X X X A X X X X X X X X X X X X X A A
A A A A A A A A A A A A A A A A A A A A A A A A A A A A A A A A